[
  [
    ["* ", "* ", "* ", "* ", "* ", "* ", "* ", "* ", "* ", "* ", "* ", "* ", "* ", "* ", "* "],
    ["* ", "* ", "* ", "* ", "* ", "* ", "* ", "* ", "* ", "* ", "* ", "* ", "* ", "* ", "* "],
    ["* ", "* ", "* ", "* ", "* ", "* ", "* ", "* ", "* ", "* ", "* ", "* ", "* ", "* ", "* "],
    ["* ", "* ", "* ", "* ", "* ", "* ", "* ", "* ", "* ", "* ", "* ", "* ", "* ", "* ", "* "],
    ["* ", "* ", "* ", "* ", "* ", "* ", "* ", "* ", "* ", "* ", "* ", "* ", "* ", "* ", "* "],
    ["* ", "* ", "* ", "* ", "* ", "* ", "* ", "* ", "* ", "* ", "* ", "* ", "* ", "* ", "* "],
    ["* ", "* ", "* ", "* ", "* ", "* ", "* ", "* ", "* ", "* ", "* ", "* ", "* ", "* ", "* "],
    ["* ", "* ", "* ", "* ", "* ", "* ", "* ", "* ", "* ", "* ", "* ", "* ", "* ", "* ", "* "],
    ["* ", "* ", "* ", "* ", "* ", "* ", "* ", "* ", "* ", "* ", "* ", "* ", "* ", "* ", "* "],
    ["* ", "* ", "* ", "* ", "* ", "* ", "* ", "* ", "* ", "* ", "* ", "* ", "* ", "* ", "* "],
    ["* ", "* ", "* ", "* ", "* ", "* ", "* ", "* ", "* ", "* ", "* ", "* ", "* ", "* ", "* "],
    ["* ", "* ", "* ", "* ", "* ", "* ", "* ", "* ", "* ", "* ", "* ", "* ", "* ", "* ", "* "],
    ["* ", "* ", "* ", "* ", "* ", "* ", "* ", "* ", "* ", "* ", "* ", "* ", "* ", "* ", "* "],
    ["* ", "* ", "* ", "* ", "* ", "* ", "* ", "* ", "* ", "* ", "* ", "* ", "* ", "* ", "* "],
    ["* ", "* ", "* ", "* ", "* ", "* ", "* ", "* ", "* ", "* ", "* ", "* ", "* ", "* ", "* "]
  ],
  [
    [". ", ". ", ". ", ". ", ". ", ". ", ". ", ". ", ". ", "* ", "* ", "* ", "* ", "* ", "* "],
    [". ", ".s", "* ", ". ", ". ", ". ", ". ", ". ", ". ", "* ", ". ", ". ", ". ", ". ", "* "],
    [". ", ".s", "* ", ". ", "* ", ". ", ". ", "* ", ". ", "* ", ". ", ". ", ". ", ". ", "* "],
    [". ", ".s", "* ", ". ", ". ", ". ", ". ", ". ", ". ", "* ", ". ", ". ", ". ", ". ", "* "],
    [". ", ". ", ". ", ". ", ". ", ". ", ". ", ". ", ". ", "* ", ". ", ". ", ". ", ". ", "* "],
    [". ", ". ", ". ", ". ", ". ", ". ", ". ", ". ", ". ", "* ", ". ", "* ", "* ", ". ", "* "],
    [". ", ".s", "* ", ". ", ". ", ". ", ". ", ". ", ". ", ". ", ". ", ". ", ". ", ". ", "* "],
    [". ", ".s", "* ", ". ", ". ", "I ", "* ", ". ", ". ", ". ", ". ", ". ", ". ", ". ", "* "],
    [". ", ".s", "* ", ". ", ". ", ". ", ". ", ". ", ". ", ". ", ". ", ". ", ". ", ". ", "* "],
    [". ", ". ", ". ", ". ", ". ", ". ", ". ", ". ", ". ", "* ", ". ", "* ", "* ", ". ", "* "],
    [". ", ". ", ". ", ". ", ". ", ". ", ". ", ". ", ". ", "* ", ". ", ". ", ". ", ". ", "* "],
    [". ", ".s", "* ", ". ", ". ", ". ", ". ", ". ", ". ", "* ", ". ", ". ", ". ", ". ", "* "],
    [". ", ".s", "* ", ". ", "* ", ". ", ". ", "* ", ". ", "* ", ". ", ". ", ". ", ". ", "* "],
    [". ", ".s", "* ", ". ", ". ", ". ", ". ", ". ", ". ", "* ", ". ", ". ", "I ", "I ", "* "],
    [". ", ". ", ". ", ". ", ". ", ". ", ". ", ". ", ". ", "* ", "* ", "* ", "* ", "* ", "* "]
  ],
  [
    [". ", ". ", ". ", ". ", ". ", ". ", ". ", ". ", ". ", "* ", "* ", "* ", "* ", "* ", "* "],
    [". ", ". ", "* ", ". ", ". ", ". ", ". ", ". ", ". ", "* ", ". ", ". ", ". ", ". ", "* "],
    [". ", ". ", "* ", ". ", ". ", ". ", ". ", ". ", ". ", "* ", ". ", ". ", ". ", ". ", "* "],
    [". ", ". ", "* ", ". ", ". ", ". ", ". ", ". ", ". ", "* ", ". ", ". ", ". ", ". ", "* "],
    [". ", ". ", ". ", ". ", ". ", ". ", ". ", ". ", ". ", "* ", ". ", ". ", ". ", ". ", "* "],
    [". ", ". ", ". ", ". ", ". ", ". ", ". ", ". ", ". ", "* ", ". ", "* ", "* ", ". ", "* "],
    [". ", ". ", "* ", ". ", ". ", ". ", ". ", ". ", ". ", ". ", ". ", "_ ", "_ ", ". ", "* "],
    [". ", ". ", "* ", ". ", ". ", ". ", ". ", ". ", ". ", ". ", ". ", "_ ", "_ ", "_ ", "* "],
    [". ", ". ", "* ", ". ", ". ", ". ", ". ", ". ", ". ", ". ", ". ", "_ ", "_ ", ". ", "* "],
    [". ", ". ", ". ", ". ", ". ", ". ", ". ", ". ", ". ", "* ", ". ", "* ", "* ", ". ", "* "],
    [". ", ". ", ". ", ". ", ". ", ". ", ". ", ". ", ". ", "* ", ". ", ". ", ". ", ". ", "* "],
    [". ", ". ", "* ", ". ", ". ", ". ", ". ", ". ", ". ", "* ", ". ", ". ", ". ", ". ", "* "],
    [". ", ". ", "* ", ". ", ". ", ". ", ". ", ". ", ". ", "* ", ". ", ". ", ". ", ". ", "* "],
    [". ", ". ", "* ", ". ", ". ", ". ", ". ", ". ", ". ", "* ", ". ", ". ", ". ", ". ", "* "],
    [". ", ". ", ". ", ". ", ". ", ". ", ". ", ". ", ". ", "* ", "* ", "* ", "* ", "* ", "* "]
  ],
  [
    [". ", ". ", ". ", ". ", ". ", ". ", ". ", ". ", ". ", "* ", "* ", "* ", "* ", "* ", "* "],
    [". ", ". ", ". ", ". ", ". ", ". ", ". ", ". ", ". ", "* ", ". ", ". ", ". ", ". ", "* "],
    [". ", ". ", ". ", ". ", ". ", ". ", ". ", ". ", ". ", "* ", ". ", ". ", ". ", ". ", "* "],
    [". ", ". ", ". ", ". ", ". ", ". ", ". ", ". ", ". ", "* ", ". ", ". ", ". ", ". ", "* "],
    [". ", ". ", ". ", ". ", ". ", ". ", ". ", ". ", ". ", "* ", ". ", ". ", ". ", ". ", "* "],
    [". ", ". ", ". ", ". ", ". ", ". ", ". ", ". ", ". ", "* ", ". ", ". ", ". ", ". ", "* "],
    [". ", ". ", ". ", ". ", ". ", ". ", ". ", ". ", ". ", "* ", ". ", ". ", ". ", ". ", "* "],
    [". ", ". ", ". ", ". ", ". ", ". ", ". ", ". ", ". ", "* ", ". ", ". ", ". ", ". ", "* "],
    [". ", ". ", ". ", ". ", ". ", ". ", ". ", ". ", ". ", "* ", ". ", ". ", ". ", ". ", "* "],
    [". ", ". ", ". ", ". ", ". ", ". ", ". ", ". ", ". ", "* ", ". ", ". ", ". ", ". ", "* "],
    [". ", ". ", ". ", ". ", ". ", ". ", ". ", ". ", ". ", "* ", ". ", ". ", ". ", ". ", "* "],
    [". ", ". ", ". ", ". ", ". ", ". ", ". ", ". ", ". ", "* ", ". ", ". ", ". ", ". ", "* "],
    [". ", ". ", ". ", ". ", ". ", ". ", ". ", ". ", ". ", "* ", ". ", ". ", ". ", ". ", "* "],
    [". ", ". ", ". ", ". ", ". ", ". ", ". ", ". ", ". ", "* ", ". ", ". ", ". ", ". ", "* "],
    [". ", ". ", ". ", ". ", ". ", ". ", ". ", ". ", ". ", "* ", "* ", "* ", "* ", "* ", "* "]
  ],
  [
    [". ", ". ", ". ", ". ", ". ", ". ", ". ", ". ", ". ", "* ", "* ", "* ", "* ", "* ", "* "],
    [". ", ". ", ". ", ". ", ". ", ". ", ". ", ". ", ". ", "* ", "* ", "* ", "* ", "* ", "* "],
    [". ", ". ", ". ", ". ", ". ", ". ", ". ", ". ", ". ", "* ", "* ", "* ", "* ", "* ", "* "],
    [". ", ". ", ". ", ". ", ". ", ". ", ". ", ". ", ". ", "* ", "* ", "* ", "* ", "* ", "* "],
    [". ", ". ", ". ", ". ", ". ", ". ", ". ", ". ", ". ", "* ", "* ", "* ", "* ", "* ", "* "],
    [". ", ". ", ". ", ". ", ". ", ". ", ". ", ". ", ". ", "* ", "* ", "* ", "* ", "* ", "* "],
    [". ", ". ", ". ", ". ", ". ", ". ", ". ", ". ", ". ", "* ", "* ", "* ", "* ", "* ", "* "],
    [". ", ". ", ". ", ". ", ". ", ". ", ". ", ". ", ". ", "* ", "* ", "* ", "* ", "* ", "* "],
    [". ", ". ", ". ", ". ", ". ", ". ", ". ", ". ", ". ", "* ", "* ", "* ", "* ", "* ", "* "],
    [". ", ". ", ". ", ". ", ". ", ". ", ". ", ". ", ". ", "* ", "* ", "* ", "* ", "* ", "* "],
    [". ", ". ", ". ", ". ", ". ", ". ", ". ", ". ", ". ", "* ", "* ", "* ", "* ", "* ", "* "],
    [". ", ". ", ". ", ". ", ". ", ". ", ". ", ". ", ". ", "* ", "* ", "* ", "* ", "* ", "* "],
    [". ", ". ", ". ", ". ", ". ", ". ", ". ", ". ", ". ", "* ", "* ", "* ", "* ", "* ", "* "],
    [". ", ". ", ". ", ". ", ". ", ". ", ". ", ". ", ". ", "* ", "* ", "* ", ". ", ". ", "* "],
    [". ", ". ", ". ", ". ", ". ", ". ", ". ", ". ", ". ", "* ", "* ", "* ", "* ", "* ", "* "]
  ],
  [
    [". ", ". ", ". ", ". ", ". ", ". ", ". ", ". ", ". ", "* ", "* ", "* ", "* ", "* ", "* "],
    [". ", ". ", ". ", ". ", ". ", ". ", ". ", ". ", ". ", "* ", "_ ", "_ ", "_ ", "_ ", "* "],
    [". ", ". ", ". ", ". ", ". ", ". ", ". ", ". ", ". ", "* ", ". ", "* ", ". ", "* ", "* "],
    [". ", ". ", ". ", ". ", ". ", ". ", ". ", ". ", ". ", ". ", ". ", ". ", ". ", ". ", "* "],
    [". ", ". ", ". ", ". ", ". ", ". ", ". ", ". ", ". ", "* ", ". ", ". ", ". ", ". ", "* "],
    [". ", ". ", ". ", ". ", ". ", ". ", ". ", ". ", ". ", ". ", ". ", "* ", ". ", "* ", "* "],
    [". ", ". ", ". ", ". ", ". ", ". ", ". ", ". ", ". ", "* ", ". ", ". ", ". ", ". ", "* "],
    [". ", ". ", ". ", ". ", ". ", ". ", ". ", ". ", ". ", ". ", ". ", "* ", ". ", "* ", "* "],
    [". ", ". ", ". ", ". ", ". ", ". ", ". ", ". ", ". ", "* ", ". ", ". ", ". ", ". ", "* "],
    [". ", ". ", ". ", ". ", ". ", ". ", ". ", ". ", ". ", ". ", ". ", "* ", ". ", "* ", "* "],
    [". ", ". ", ". ", ". ", ". ", ". ", ". ", ". ", ". ", "* ", ". ", ". ", ". ", ". ", "* "],
    [". ", ". ", ". ", ". ", ". ", ". ", ". ", ". ", ". ", ". ", ". ", ". ", ". ", ". ", "* "],
    [". ", ". ", ". ", ". ", ". ", ". ", ". ", ". ", ". ", "* ", ". ", "* ", ". ", "* ", "* "],
    [". ", ". ", ". ", ". ", ". ", ". ", ". ", ". ", ". ", ". ", ". ", ". ", ". ", ". ", "* "],
    [". ", ". ", ". ", ". ", ". ", ". ", ". ", ". ", ". ", "* ", "* ", "* ", "* ", "* ", "* "]
  ],
  [
    [". ", ". ", ". ", ". ", ". ", ". ", ". ", ". ", ". ", "* ", "* ", "* ", "* ", "* ", "* "],
    [". ", ". ", ". ", ". ", ". ", ". ", ". ", ". ", ". ", "* ", ". ", ". ", "I ", "I ", "* "],
    [". ", ". ", ". ", ". ", ". ", ". ", ". ", ". ", ". ", "* ", ". ", ". ", ". ", ". ", "* "],
    [". ", ". ", ". ", ". ", ". ", ". ", ". ", ". ", ". ", "* ", ". ", ". ", ". ", ". ", "* "],
    [". ", ". ", ". ", ". ", ". ", ". ", ". ", ". ", ". ", "* ", ". ", ". ", ". ", ". ", "* "],
    [". ", ". ", ". ", ". ", ". ", ". ", ". ", ". ", ". ", "* ", ". ", ". ", ". ", ". ", "* "],
    [". ", ". ", ". ", ". ", ". ", ". ", ". ", ". ", ". ", "* ", ". ", ". ", ". ", ". ", "* "],
    [". ", ". ", ". ", ". ", ". ", ". ", ". ", ". ", ". ", "* ", ". ", ". ", ". ", ". ", "* "],
    [". ", ". ", ". ", ". ", ". ", ". ", ". ", ". ", ". ", "* ", ". ", ". ", ". ", ". ", "* "],
    [". ", ". ", ". ", ". ", ". ", ". ", ". ", ". ", ". ", "* ", ". ", ". ", ". ", ". ", "* "],
    [". ", ". ", ". ", ". ", ". ", ". ", ". ", ". ", ". ", "* ", ". ", ". ", ". ", ". ", "* "],
    [". ", ". ", ". ", ". ", ". ", ". ", ". ", ". ", ". ", "* ", ". ", ". ", ". ", ". ", "* "],
    [". ", ". ", ". ", ". ", ". ", ". ", ". ", ". ", ". ", "* ", ". ", ". ", ". ", ". ", "* "],
    [". ", ". ", ". ", ". ", ". ", ". ", ". ", ". ", ". ", "* ", ". ", ". ", ". ", ". ", "* "],
    [". ", ". ", ". ", ". ", ". ", ". ", ". ", ". ", ". ", "* ", "* ", "* ", "* ", "* ", "* "]
  ],
  [
    [". ", ". ", ". ", ". ", ". ", ". ", ". ", ". ", ". ", "* ", "* ", "* ", "* ", "* ", "* "],
    [". ", ". ", ". ", ". ", ". ", ". ", ". ", ". ", ". ", "* ", "* ", "* ", ". ", ". ", "* "],
    [". ", ". ", ". ", ". ", ". ", ". ", ". ", ". ", ". ", "* ", "* ", "* ", "* ", "* ", "* "],
    [". ", ". ", ". ", ". ", ". ", ". ", ". ", ". ", ". ", "* ", "* ", "* ", "* ", "* ", "* "],
    [". ", ". ", ". ", ". ", ". ", ". ", ". ", ". ", ". ", "* ", "* ", "* ", "* ", "* ", "* "],
    [". ", ". ", ". ", ". ", ". ", ". ", ". ", ". ", ". ", "* ", "* ", "* ", "* ", "* ", "* "],
    [". ", ". ", ". ", ". ", ". ", ". ", ". ", ". ", ". ", "* ", "* ", "* ", "* ", "* ", "* "],
    [". ", ". ", ". ", ". ", ". ", ". ", ". ", ". ", ". ", "* ", "* ", "* ", "* ", "* ", "* "],
    [". ", ". ", ". ", ". ", ". ", ". ", ". ", ". ", ". ", "* ", "* ", "* ", "* ", "* ", "* "],
    [". ", ". ", ". ", ". ", ". ", ". ", ". ", ". ", ". ", "* ", "* ", "* ", "* ", "* ", "* "],
    [". ", ". ", ". ", ". ", ". ", ". ", ". ", ". ", ". ", "* ", "* ", "* ", "* ", "* ", "* "],
    [". ", ". ", ". ", ". ", ". ", ". ", ". ", ". ", ". ", "* ", "* ", "* ", "* ", "* ", "* "],
    [". ", ". ", ". ", ". ", ". ", ". ", ". ", ". ", ". ", "* ", "* ", "* ", "* ", "* ", "* "],
    [". ", ". ", ". ", ". ", ". ", ". ", ". ", ". ", ". ", "* ", "* ", "* ", "* ", "* ", "* "],
    [". ", ". ", ". ", ". ", ". ", ". ", ". ", ". ", ". ", "* ", "* ", "* ", "* ", "* ", "* "]
  ],
  [
    [". ", ". ", ". ", ". ", ". ", ". ", ". ", ". ", ". ", "* ", ". ", "* ", "* ", ". ", "* "],
    [". ", ". ", ". ", ". ", ". ", ". ", ". ", ". ", ". ", ". ", ". ", ". ", ". ", ". ", ". "],
    [". ", ". ", ". ", ". ", ". ", ". ", ". ", ". ", ". ", "* ", ". ", ". ", ". ", ". ", "* "],
    [". ", ". ", ". ", ". ", ". ", ". ", ". ", ". ", ". ", ". ", ". ", ". ", ". ", ". ", ". "],
    [". ", ". ", ". ", ". ", ". ", ". ", ". ", ". ", ". ", "* ", ". ", ". ", ". ", ". ", "* "],
    [". ", ". ", ". ", ". ", ". ", ". ", ". ", ". ", ". ", ". ", ". ", ". ", ". ", ". ", ". "],
    [". ", ". ", ". ", ". ", ". ", ". ", ". ", ". ", ". ", "* ", ". ", ". ", ". ", ". ", "* "],
    [". ", ". ", ". ", ". ", ". ", ". ", ". ", ". ", ". ", ". ", ". ", "I ", ".s", ". ", ". "],
    [". ", ". ", ". ", ". ", ". ", ". ", ". ", ". ", ". ", "* ", ". ", ". ", ". ", ". ", "* "],
    [". ", ". ", ". ", ". ", ". ", ". ", ". ", ". ", ". ", ". ", ". ", ". ", ". ", ". ", ". "],
    [". ", ". ", ". ", ". ", ". ", ". ", ". ", ". ", ". ", "* ", ". ", ". ", ". ", ". ", "* "],
    [". ", ". ", ". ", ". ", ". ", ". ", ". ", ". ", ". ", ". ", ". ", ". ", ". ", ". ", ". "],
    [". ", ". ", ". ", ". ", ". ", ". ", ". ", ". ", ". ", "* ", ". ", ". ", ". ", ". ", "* "],
    [". ", ". ", ". ", ". ", ". ", ". ", ". ", ". ", ". ", ". ", ". ", ". ", ". ", ". ", ". "],
    [". ", ". ", ". ", ". ", ". ", ". ", ". ", ". ", ". ", "* ", ". ", "* ", "* ", ". ", "* "]
  ]
]