[
  [
    ["* ", "* ", "* ", "* ", "* ", "* ", "* ", "* ", "* ", "* ", "* ", "* ", "* ", "* ", "* "],
    ["* ", "* ", "* ", "* ", "* ", "* ", "* ", "* ", "* ", "* ", "* ", "* ", "* ", "* ", "* "],
    ["* ", "* ", "* ", "* ", "* ", "* ", "* ", "* ", "* ", "* ", "* ", "* ", "* ", "* ", "* "],
    ["* ", "* ", "* ", "* ", "* ", "* ", "* ", "* ", "* ", "* ", "* ", "* ", "* ", "* ", "* "],
    ["* ", "* ", "* ", "* ", "* ", "* ", "* ", "* ", "* ", "* ", "* ", "* ", "* ", "* ", "* "],
    ["* ", "* ", "* ", "* ", "* ", "* ", "* ", "* ", "* ", "* ", "* ", "* ", "* ", "* ", "* "],
    ["* ", "* ", "* ", "* ", "* ", "* ", "* ", "* ", "* ", "* ", "* ", "* ", "* ", "* ", "* "],
    ["* ", "* ", "* ", "* ", "* ", "* ", "* ", "* ", "* ", "* ", "* ", "* ", "* ", "* ", "* "],
    ["* ", "* ", "* ", "* ", "* ", "* ", "* ", "* ", "* ", "* ", "* ", "* ", "* ", "* ", "* "],
    ["* ", "* ", "* ", "* ", "* ", "* ", "* ", "* ", "* ", "* ", "* ", "* ", "* ", "* ", "* "],
    ["* ", "* ", "* ", "* ", "* ", "* ", "* ", "* ", "* ", "* ", "* ", "* ", "* ", "* ", "* "],
    ["* ", "* ", "* ", "* ", "* ", "* ", "* ", "* ", "* ", "* ", "* ", "* ", "* ", "* ", "* "],
    ["* ", "* ", "* ", "* ", "* ", "* ", "* ", "* ", "* ", "* ", "* ", "* ", "* ", "* ", "* "],
    ["* ", "* ", "* ", "* ", "* ", "* ", "* ", "* ", "* ", "* ", "* ", "* ", "* ", "* ", "* "],
    ["* ", "* ", "* ", "* ", "* ", "* ", "* ", "* ", "* ", "* ", "* ", "* ", "* ", "* ", "* "]
  ],
  [
    [". ", ". ", ". ", ". ", ". ", ". ", ". ", ". ", ". ", ". ", ". ", ". ", ". ", ". ", ". "],
    [". ", ". ", ". ", ". ", ". ", ". ", ". ", ". ", ". ", ". ", ". ", ". ", ". ", ". ", ". "],
    [". ", ". ", ".s", ". ", ". ", ". ", ". ", ". ", ". ", ". ", ". ", ". ", ". ", ". ", ". "],
    [". ", ". ", ". ", ". ", ". ", ". ", "* ", ". ", "* ", ". ", ". ", ". ", ". ", ". ", ". "],
    [". ", ". ", ". ", ". ", ". ", ". ", ". ", ". ", ". ", ". ", ". ", ". ", ". ", ". ", ". "],
    [". ", ". ", ". ", ". ", ". ", ". ", ". ", ". ", ". ", ". ", ". ", ". ", ". ", ". ", ". "],
    [". ", ". ", ". ", "* ", ". ", ". ", ". ", ". ", ". ", ". ", ". ", "* ", ". ", ". ", ". "],
    [". ", ". ", ". ", ". ", ". ", ". ", ". ", "* ", ". ", ". ", ". ", ". ", ". ", ". ", ". "],
    [". ", ". ", ". ", "* ", ". ", ". ", ". ", "_ ", ". ", ". ", ". ", "* ", ". ", ". ", ". "],
    [". ", ". ", ". ", ". ", ". ", ". ", ". ", "_ ", ". ", ". ", ". ", ". ", ". ", ". ", ". "],
    [". ", ". ", ". ", ". ", ". ", ". ", ". ", "_ ", ". ", ". ", ". ", ". ", ". ", ". ", ". "],
    [". ", ". ", ". ", ". ", ". ", ". ", "* ", "_ ", "* ", ". ", ". ", ". ", ". ", ". ", ". "],
    [". ", ". ", ". ", ". ", ". ", ". ", ". ", ". ", ". ", ". ", ". ", ". ", ". ", ". ", ". "],
    [". ", ". ", ". ", ". ", ". ", ". ", ". ", ". ", ". ", ". ", ". ", ". ", ". ", ". ", ". "],
    [". ", ". ", ". ", ". ", ". ", ". ", ". ", ". ", ". ", ". ", ". ", ". ", ". ", ". ", ". "]
  ],
  [
    [". ", ". ", ". ", ". ", ". ", ". ", ". ", ". ", ". ", ". ", ". ", ". ", ". ", ". ", ". "],
    [". ", ". ", ". ", ". ", ". ", ". ", ". ", ". ", ". ", ". ", ". ", ". ", ". ", ". ", ". "],
    [". ", ". ", ". ", ". ", ". ", ". ", ". ", ". ", ". ", ". ", ". ", ". ", ". ", ". ", ". "],
    [". ", ". ", ". ", ". ", ". ", ". ", "* ", ". ", "* ", ". ", ". ", ". ", ". ", ". ", ". "],
    [". ", ". ", ". ", ". ", ". ", ". ", ". ", ". ", ". ", ". ", ". ", ". ", ". ", ". ", ". "],
    [". ", ". ", ". ", ". ", ". ", ". ", ". ", ". ", ". ", ". ", ". ", ". ", ". ", ". ", ". "],
    [". ", ". ", ". ", "* ", ". ", ". ", "* ", ". ", "* ", ". ", ". ", "* ", ". ", ". ", ". "],
    [". ", ". ", ". ", ". ", ". ", ". ", ". ", "I ", ". ", ". ", ". ", ". ", ". ", ". ", ". "],
    [". ", ". ", ". ", "* ", ". ", ". ", "* ", ". ", "* ", ". ", ". ", "* ", ". ", ". ", ". "],
    [". ", ". ", ". ", ". ", ". ", ". ", ". ", ". ", ". ", ". ", ". ", ". ", ". ", ". ", ". "],
    [". ", ". ", ". ", ". ", ". ", ". ", ". ", ". ", ". ", ". ", ". ", ". ", ". ", ". ", ". "],
    [". ", ". ", ". ", ". ", ". ", ". ", "* ", ".s", "* ", ". ", ". ", ". ", ". ", ". ", ". "],
    [". ", ". ", ". ", ". ", ". ", ". ", ". ", ". ", ". ", ". ", ". ", ". ", ". ", ". ", ". "],
    [". ", ". ", ". ", ". ", ". ", ". ", ". ", ". ", ". ", ". ", ". ", ". ", ". ", ". ", ". "],
    [". ", ". ", ". ", ". ", ". ", ". ", ". ", ". ", ". ", ". ", ". ", ". ", ". ", ". ", ". "]
  ]
]