FLOOR 1
* * * * * * * * * * * * * * * 
* * * * * * * * * * * * * * * 
* * * * * * * * * * * * * * * 
* * * * * * * * * * * * * * * 
* * * * * * * * * * * * * * * 
* * * * * * * * * * * * * * * 
* * * * * * * * * * * * * * * 
* * * * * * * * * * * * * * * 
* * * * * * * * * * * * * * * 
* * * * * * * * * * * * * * * 
* * * * * * * * * * * * * * * 
* * * * * * * * * * * * * * * 
* * * * * * * * * * * * * * * 
* * * * * * * * * * * * * * * 
* * * * * * * * * * * * * * * 
FLOOR 2
. . . . . . . . . . . . . . . 
. . . . . . . . . . . . . . . 
. . . . . . . . . . . . . . . 
. . . . . . . . . . . . . . . 
. . . . . . * . * . . . . . . 
. . . . . . . . . . . . . . . 
. . . . * . . . . . * . . . . 
. . . . . . . . . . . . . . . 
. . . . * . . . . . * . . . . 
. . . . . . . . . . . . . . . 
. . . . . . * . * . . . . . . 
. . . . . . . . . . . . . . . 
. . . . . . . . . . . . . . . 
. . . . . . . . . . . . . . . 
. . . . . . . . . . . . . . . 